11111111111111111111
1C000000110010000011
11011010010F00101011
1C000001000111100001
100011C0101000011011
10111111100111111001
1C1E00000000000C10P1
11111111111111111111
