111111111111111
101000C100000F1
1PC000000C00001
101111110000111
10001011000C011
111000111100001
110001111C01111
111100000001111
11E001110000C01
111111111111011
111111111111111
